1111111111111
1001000100001
1000000000001
1P00000000111
1111000000001
100000010N001
10000001NNNE1
10C0000100001
1001001001001
1111111111111
