1111111111111111111111111111111111111111
100E000000000000000100000000000000000001
1011111111011111110101111111011111111101
10P0000000000000000000000000000000000001
11011101110101111111011111110101111110
1100000000010001100000000011010000000011
1101110111010100101101101000010111110111
11000000000101101010001011110100000001
1101110110110110101111100000010110111111
1000000000000000000000001111000000000001
1011111111011111110101111111011111111101
100000000000000C000100000000000000000001
1111111111111111111111111111111111111111
