1111111111111111111111111111111111111111
100E000000000000000100000000000000000001
1011111111011111110101111111011111111101
10P0000000000000000000000000000000000001
1101110111010111111101111111010111111011
1100000000010001100000000011010000000011
1101110111010100101101101000010111110110
1100000000010110101C00101111010000000111
1101110110110110101111100000010110111111
1000000000000000000000001111000000000001
1011111111011111110101111111011111111101
1000000000000000000100000000000000000001
1111111111111111111111111111111111111111
